EWEEEEEEEE
EEEEEEEEEE
EEWEEEEEEE
EEEEE.....
EEEEE.EEEE
EEEE.EEEEE
EEEW.EEEEE
EW..EEEEEE
E..EWEEEEE
.EEWEEEEEE
